{
  "width": 15,
  "height": 15,
  "grid": [
    ["S", ".", ".", "#", ".", ".", ".", "#", ".", ".", ".", ".", ".", ".", "."],
    [".", "#", ".", "#", ".", "#", ".", "#", ".", "#", "#", "#", "#", "#", "."],
    [".", "#", ".", ".", ".", "#", ".", ".", ".", ".", ".", ".", ".", "#", "."],
    [".", "#", "#", "#", ".", "#", "#", "#", "#", "#", ".", "#", ".", "#", "."],
    [".", ".", ".", "#", ".", ".", ".", ".", ".", ".", ".", "#", ".", ".", "."],
    [".", "#", ".", "#", "#", "#", "#", "#", "#", "#", ".", "#", "#", "#", "."],
    [".", "#", ".", ".", ".", ".", ".", ".", ".", "#", ".", ".", ".", "#", "."],
    [".", "#", "#", "#", "#", "#", "#", "#", ".", "#", "#", "#", "#", "#", "."],
    [".", ".", ".", ".", ".", ".", ".", ".", ".", ".", ".", ".", ".", "#", "."],
    ["#", "#", "#", "#", "#", "#", "#", "#", "#", "#", "#", ".", "#", "#", "."],
    [".", ".", ".", ".", ".", ".", ".", ".", ".", ".", ".", ".", ".", ".", "."],
    [".", "#", "#", "#", "#", "#", "#", "#", "#", "#", "#", "#", "#", "#", "."],
    [".", ".", ".", ".", ".", ".", "K", ".", ".", ".", ".", ".", ".", "#", "."],
    [".", "#", "#", "#", "#", "#", "#", "#", "#", "#", "#", "#", "#", "#", "."],
    [".", ".", ".", ".", ".", ".", ".", ".", ".", ".", ".", ".", ".", ".", "G"]
  ]
}
