{
  "width": 20,
  "height": 20,
  "grid": [
    ["S", ".", ".", "#", ".", ".", ".", "#", ".", ".", ".", "#", ".", ".", ".", ".", ".", ".", ".", "."],
    [".", "#", ".", "#", ".", "#", ".", "#", ".", "#", ".", "#", ".", "#", "#", "#", "#", "#", ".", "."],
    [".", "#", ".", ".", ".", "#", ".", ".", ".", "#", ".", ".", ".", ".", ".", ".", ".", "#", ".", "."],
    [".", "#", "#", "#", ".", "#", "#", "#", ".", "#", "#", "#", "#", ".", "#", "#", ".", "#", "#", "."],
    [".", ".", ".", "#", ".", ".", ".", ".", ".", ".", ".", ".", "#", ".", ".", ".", ".", ".", "#", "."],
    [".", "#", ".", "#", "#", "#", "#", "#", "#", "#", ".", "#", "#", "#", "#", "#", "#", ".", "#", "."],
    [".", "#", ".", ".", ".", ".", ".", ".", ".", "#", ".", ".", ".", ".", ".", ".", "#", ".", ".", "."],
    [".", "#", "#", "#", "#", "#", "#", ".", ".", "#", "#", "#", "#", "#", "#", ".", "#", "#", "#", "."],
    [".", ".", ".", ".", ".", ".", ".", ".", ".", ".", ".", ".", ".", ".", "#", ".", ".", ".", ".", "."],
    ["#", "#", "#", "#", "#", "#", ".", "#", "#", "#", "#", "#", ".", "#", "#", "#", "#", "#", "#", "."],
    [".", ".", ".", ".", ".", ".", ".", ".", ".", ".", ".", "#", ".", ".", ".", ".", ".", ".", ".", "."],
    [".", "#", "#", "#", "#", "#", "#", "#", "#", "#", ".", "#", "#", "#", "#", "#", "#", "#", ".", "#"],
    [".", ".", ".", ".", ".", ".", ".", ".", ".", "#", ".", ".", ".", ".", ".", ".", ".", "#", ".", "."],
    [".", "#", "#", "#", "#", "#", "#", "#", ".", "#", "#", "#", "#", "#", "#", "#", ".", "#", "#", "."],
    [".", ".", ".", ".", ".", ".", ".", ".", ".", ".", ".", ".", ".", ".", ".", "#", ".", ".", ".", "."],
    ["#", "#", "#", "#", "#", "#", "#", "#", "#", "#", "#", ".", "#", "#", "#", "#", "#", "#", "#", "."],
    [".", ".", ".", ".", ".", ".", ".", ".", ".", ".", ".", ".", ".", ".", ".", ".", ".", ".", ".", "."],
    [".", "#", "#", "#", "#", "#", "#", "#", "#", "#", "#", "#", "#", "#", "#", "#", "#", "#", ".", "."],
    [".", ".", ".", ".", ".", ".", "K", ".", ".", ".", ".", ".", ".", ".", ".", ".", ".", ".", ".", "."],
    [".", "#", "#", "#", "#", "#", "#", "#", "#", "#", "#", "#", "#", "#", "#", "#", "#", "#", "#", "G"]
  ]
}
